Id,Label,Group,Num Links,Links_in,links_out,Timestamp
1,@fibaworld,top_mentions,434,403,31,1
2,@nba,top_mentions,85,49,36,2
3,@joejonas,top_mentions,5,5,0,13
4,@justinbieber,top_mentions,192,192,0,4
5,@usabasketball,top_mentions,76,75,1,1
6,@kingjames,top_mentions,72,72,0,1
7,@kdthunderup,top_mentions,4,4,0,3
9,@ozfinn,top_mentions,3,2,1,11
10,@2010misterchip,top_mentions,11,11,0,4
11,@breakingnews,top_mentions,2,2,0,9
12,@50cent,top_mentions,4,3,1,1
13,@reallamarodom,top_mentions,23,21,2,2
14,@officialgboi_,top_mentions,2,2,0,10
15,@khloekardashian,top_mentions,17,16,1,1
16,@cbb_basquete,top_mentions,8,3,5,2
17,@carmeloanthony,top_mentions,11,9,2,2
19,@lscola4,top_mentions,10,10,0,1
20,@lilduval,top_mentions,2,2,0,1
21,@rrdream,top_mentions,29,13,16,11
22,@fiba2010turkiye,top_mentions,36,33,3,4
23,@addthis,top_mentions,5,5,0,1
24,@chrisbrown,top_mentions,4,4,0,7
26,@greggdoyelcbs,top_mentions,3,3,0,9
27,@elizabethsibel,top_mentions,9,9,0,9
28,@marshaambrosius,top_mentions,1,0,1,10
29,@unbounce,top_mentions,4,1,3,5
30,@jeskeets,top_mentions,49,20,29,1
31,@follow_maria,top_mentions,8,8,0,15
32,@ardakutsal,top_mentions,2,2,0,15
33,@99designs,top_mentions,2,2,0,5
34,@trecet,top_mentions,1,1,0,13
35,@sinanguler,top_mentions,31,29,2,3
36,@ogochocinco,top_mentions,2,1,1,4
37,@adaimiel,top_mentions,2,1,1,8
38,@sportsguy33,top_mentions,5,3,2,14
40,@pelinalaca123,top_mentions,24,5,19,9
41,@bokinachbar,top_mentions,7,7,0,2
42,@the_real_shaq,top_mentions,1,1,0,1
43,@coachozyer,top_mentions,43,21,22,3
44,@dwadeofficial,top_mentions,1,1,0,8
46,@spainfansjustin,top_mentions,131,85,46,4
47,@handeyenerr,top_mentions,5,5,0,15
48,@twitturk,top_mentions,2,2,0,15
49,@lithuaniabasket,top_mentions,67,37,30,1
50,@bek_rt,top_mentions,14,6,8,14
51,@tribundergi,Normal_users,6,4,2,5
53,@petethamelnyt,Normal_users,17,11,6,1
54,@blkice3,Normal_users,4,3,1,8
55,@dare_2_follow,Normal_users,22,8,14,14
56,@reflexionfidel,Normal_users,4,4,0,17
57,@richarddeitsch,Normal_users,7,6,1,3
61,@desireejustinb,top_twitters,346,68,278,4
62,@algomaubball,Normal_users,2,1,1,8
63,@jaythewanted,Normal_users,5,3,2,2
64,@cenkakyol,Normal_users,4,3,1,10
65,@germanyff,Normal_users,11,11,0,11
66,@iilovemeduhh,Normal_users,13,8,5,9
67,@alanstein,Normal_users,11,3,8,2
70,@ioninteractive,Normal_users,11,4,7,5
71,@espn4d,Normal_users,3,1,2,13
72,@ludacris,Normal_users,6,6,0,9
73,@imjonassister,Normal_users,40,40,0,2
74,@espn,Normal_users,5,5,0,1
76,@sinanakciloffcl,Normal_users,6,4,2,4
78,@candace_parker,Normal_users,9,5,4,8
79,@omurgedik,Normal_users,4,2,2,15
80,@manuginobili,Normal_users,2,2,0,15
84,@qldyounglnp,Normal_users,5,5,0,7
85,@geeksrulz,Normal_users,17,4,13,3
86,@youtube,Normal_users,3,3,0,8
87,@rudygay22,Normal_users,7,4,3,3
88,@nurbieber,Normal_users,15,3,12,4
89,@gurul,Normal_users,5,2,3,15
91,@cdouglasroberts,Normal_users,2,1,1,6
92,@selincetin,Normal_users,10,4,6,15
93,@jlsaezfeb,Normal_users,6,4,2,8
94,@ashleyjeffreyjb,Normal_users,26,6,20,9
95,@amareisreal,Normal_users,6,4,2,7
96,@hoopshype,Normal_users,4,4,0,2
98,@vampyrse,top_twitters,28,21,7,2
99,@espn_collhoops,Normal_users,9,3,6,3
100,@the_real_nash,Normal_users,6,4,2,8
102,@evrembieber,Normal_users,12,3,9,15
103,@espnandykatz,Normal_users,4,3,1,5
104,@vzlaembassyus,Normal_users,2,2,0,17
106,@wnba,Normal_users,6,1,5,9
107,@stephencurry30,Normal_users,2,2,0,3
109,@brettmcmurphy,Normal_users,3,3,0,9
110,@jimmywa11,Normal_users,7,2,5,2
111,@iremkusoglu,Normal_users,13,7,6,12
112,@garyowencomedy,Normal_users,1,1,0,15
115,@lakers,Normal_users,4,4,0,4
116,@2ksports,Normal_users,8,4,4,7
117,@utkucakir,Normal_users,3,2,1,15
118,@presidentgee,Normal_users,1,1,0,8
122,@tim_ash,Normal_users,17,6,11,10
123,@tasmelas,Normal_users,30,12,18,4
125,@angelalessandra,Normal_users,2,2,0,3
129,@ai9,Normal_users,5,5,0,3
130,@kimkardashian,Normal_users,2,2,0,16
131,@chrislittmann,Normal_users,4,3,1,3
132,@bucks,Normal_users,20,10,10,3
133,@strongerteam,Normal_users,9,9,0,4
134,@mahmutcankovan,Normal_users,2,2,0,15
139,@hoopstar4lyfe,Normal_users,26,13,13,4
140,@davidmarca,Normal_users,4,2,2,12
141,@canuyanik,Normal_users,4,3,1,12
142,@axeloficial,Normal_users,4,0,4,5
143,@antonmeana,Normal_users,3,3,0,16
147,@tsevis,Normal_users,9,7,2,1
149,@nickjonas,Normal_users,1,1,0,5
150,@johnschuhmann,Normal_users,11,8,3,4
151,@insidehoops,Normal_users,2,2,0,4
156,@nbaturks,top_twitters,38,9,29,1
157,@melissaaggie98,Normal_users,51,17,34,2
162,@sirolopez,Normal_users,2,1,1,4
163,@recklesz_belle,Normal_users,2,1,1,16
166,@j_flynn,Normal_users,1,1,0,3
168,@germancartaya,Normal_users,4,3,1,2
169,@burki_rock,top_twitters,83,9,74,2
170,@breezecomfort,Normal_users,17,17,0,2
172,@andy_staples,Normal_users,3,0,3,5
174,@vamofalademacho,Normal_users,4,2,2,7
176,@shannonbrown,Normal_users,1,1,0,16
177,@joebudden,Normal_users,7,5,2,15
179,@dickiev,Normal_users,1,1,0,3
180,@scavendish,Normal_users,5,3,2,14
181,@russwest44,Normal_users,1,1,0,3
183,@danwolken,Normal_users,2,1,1,1
184,@syrertm,Normal_users,15,3,12,15
186,@laurencestlavie,Normal_users,7,4,3,3
188,@iamiceberg,Normal_users,7,4,3,3
189,@bomani_jones,Normal_users,3,2,1,4
191,@sexfameweezy,Normal_users,6,3,3,16
192,@rafeboogs,Normal_users,16,8,8,1
193,@jadande,Normal_users,1,1,0,11
194,@euro_adventures,Normal_users,20,11,9,2
196,@alpalkas,Normal_users,3,2,1,6
198,@ronartestcom,Normal_users,6,4,2,10
199,@lubnaaprillia,Normal_users,53,21,32,7
201,@kemaldogulu,Normal_users,7,5,2,15
206,@wesrucker,Normal_users,3,1,2,7
208,@rt,Normal_users,1,1,0,14
209,@revillaz,Normal_users,28,14,14,8
211,@mucahityilmaz,Normal_users,36,4,32,1
215,@em4r,Normal_users,5,2,3,12
216,@csheridanespn,Normal_users,5,5,0,9
218,@rockypadila,Normal_users,6,1,5,6
219,@porloschicos,Normal_users,2,1,1,14
220,@inthebleachers,Normal_users,3,0,3,6
221,@freedarko,Normal_users,8,5,3,5
222,@cabezadelfino,Normal_users,7,7,0,1
223,@barackobama,Normal_users,1,1,0,15
225,@trakedi,Normal_users,3,2,1,15
226,@raptors,Normal_users,1,0,1,4
228,@nate_robinson,Normal_users,2,1,1,4
229,@isthather,Normal_users,5,3,2,15
231,@goodmanonfox,Normal_users,4,4,0,6
232,@fifacom2010,Normal_users,4,4,0,7
234,@ajcsportseditor,Normal_users,1,1,0,3
236,@seattlestorm,Normal_users,4,4,0,9
237,@sanchezmarca,Normal_users,6,3,3,9
241,@garyparrishcbs,Normal_users,2,0,2,7
243,@draftexpress,Normal_users,2,1,1,4
244,@byuathletics,Normal_users,1,1,0,15
245,@thaythul,Normal_users,57,22,35,1
246,@souljaboy,Normal_users,1,1,0,11
248,@shekhaidemov,Normal_users,1,1,0,5
249,@rubyredrussian,Normal_users,25,7,18,5
251,@officiallyice,Normal_users,16,5,11,6
252,@nbaonespn,Normal_users,3,0,3,9
254,@lukabassin,Normal_users,14,6,8,4
255,@linkin_theorist,Normal_users,28,18,10,1
256,@joejonasfuture,Normal_users,2,0,2,13
257,@j_ipek_b,Normal_users,7,1,6,15
258,@gulcekiz,Normal_users,6,0,6,15
259,@cubadebate,Normal_users,1,0,1,17
261,@canereler,Normal_users,22,13,9,3
262,@ahuozyurt,Normal_users,1,1,0,6
264,@serdarito,top_twitters,36,15,21,1
265,@omurvarol,Normal_users,5,1,4,15
266,@mmaestracci,Normal_users,3,1,2,9
267,@jonesonthenba,Normal_users,9,3,6,1
269,@frayayah,Normal_users,21,21,0,1
271,@beebero,Normal_users,21,21,0,1
272,@abduzeedo,Normal_users,3,1,2,4
273,@therecruitscoop,Normal_users,3,1,2,1
274,@niggaimdaddy,Normal_users,8,4,4,12
275,@marcelodecasas,Normal_users,1,1,0,7
277,@geishatorres,Normal_users,3,2,1,7
278,@dtlal,Normal_users,25,18,7,1
281,@boiledsports,Normal_users,5,2,3,2
282,@shesmclovin,Normal_users,6,4,2,5
283,@salsabasket,Normal_users,8,4,4,4
287,@nyliberty,Normal_users,1,1,0,9
288,@nanimami,Normal_users,4,2,2,11
289,@michaelbyrnes,Normal_users,3,3,0,3
290,@maurice_creek3,Normal_users,1,0,1,11
291,@lovethekardash,Normal_users,5,1,4,8
293,@gangbadoy,Normal_users,1,0,1,15
297,@dheassqia,Normal_users,29,15,14,7
299,@cappa23,Normal_users,2,1,1,3
300,@austinrivers25,Normal_users,3,3,0,4
301,@usopen,Normal_users,2,2,0,11
302,@tiagosplitter,Normal_users,2,2,0,1
304,@s,Normal_users,1,1,0,2
305,@ryankellyct,Normal_users,1,0,1,5
307,@ronnyturiaf14,Normal_users,6,3,3,7
308,@rmcclanaghannba,Normal_users,1,1,0,10
309,@raysahramadhani,Normal_users,27,13,14,7
310,@nelly_mo,Normal_users,2,2,0,10
311,@mestremachado,Normal_users,1,1,0,6
312,@melikekzldogan,Normal_users,15,0,15,2
313,@killakay_,Normal_users,12,7,5,6
315,@jalenrose,Normal_users,4,0,4,7
317,@ihatekatstacks,Normal_users,1,0,1,8
318,@iconjane,Normal_users,2,0,2,15
319,@gbagaunmopol,Normal_users,1,0,1,3
321,@espn3,Normal_users,1,1,0,15
323,@conversionconf,Normal_users,9,6,3,12
325,@bfeldmanespn,Normal_users,3,1,2,1
326,@balliever,Normal_users,1,0,1,2
328,@althychal,Normal_users,18,18,0,1
331,@vanbreezyy,Normal_users,4,4,0,8
332,@tuncozgorener,Normal_users,15,8,7,4
334,@sporstudyosu,Normal_users,1,1,0,4
335,@septianiriski,Normal_users,34,17,17,4
336,@raditttt,Normal_users,34,17,17,4
337,@puertoricopur,Normal_users,10,3,7,2
338,@patty_mills,Normal_users,1,1,0,3
340,@mikestuchbery,Normal_users,1,1,0,11
341,@maliano,Normal_users,11,9,2,3
342,@lusagad,Normal_users,20,7,13,2
343,@kontamonsta,Normal_users,12,4,8,1
345,@ihoopstweets,Normal_users,2,2,0,9
347,@houstonrockets,Normal_users,2,0,2,11
350,@george_hill3,Normal_users,2,1,1,13
351,@dgranger33,Normal_users,3,3,0,4
352,@dgoneil1,Normal_users,5,3,2,3
355,@darlynnb,Normal_users,6,3,3,3
356,@curropar,Normal_users,10,2,8,3
357,@aussieboomers,Normal_users,1,1,0,16
358,@as_inako,Normal_users,1,1,0,5
359,@_cube_,Normal_users,9,5,4,5
361,@wildcats,Normal_users,2,1,1,4
362,@vientoarg,Normal_users,10,5,5,5
365,@rickey57,Normal_users,31,5,26,3
367,@nuathletics,Normal_users,1,1,0,3
370,@mepongodepie,Normal_users,16,11,5,4
371,@mainbasket,Normal_users,7,1,6,1
373,@josh_ward,Normal_users,1,0,1,15
374,@jokersoserious,Normal_users,8,6,2,3
375,@jhokanson,Normal_users,3,3,0,1
376,@its_ton,Normal_users,14,11,3,8
380,@fnur,Normal_users,2,1,1,3
382,@delly707,Normal_users,14,7,7,13
383,@d1scourse,Normal_users,4,2,2,6
386,@allieincredible,Normal_users,2,1,1,15
387,@ajkaliboy2,Normal_users,11,5,6,3
388,@7vueltas,Normal_users,3,1,2,5
389,@williamdsaputra,Normal_users,8,4,4,6
390,@t_newschronicle,Normal_users,26,13,13,2
392,@saostiram,Normal_users,37,13,24,7
395,@pedrerol,Normal_users,2,2,0,9
396,@orangetangel,Normal_users,1,0,1,7
398,@ncaafanhouse,Normal_users,1,1,0,15
399,@mrgoodshot,Normal_users,1,1,0,16
400,@maldinisport,Normal_users,1,1,0,13
401,@ltumarty,Normal_users,9,9,0,4
405,@itsillmatic,Normal_users,3,1,2,15
406,@ipeksubiebz,Normal_users,5,5,0,15
407,@imilly21,Normal_users,4,2,2,16
409,@guillenfran,Normal_users,3,2,1,5
410,@greenday,Normal_users,5,5,0,11
411,@gitti_,Normal_users,30,11,19,1
413,@franciscovega,Normal_users,2,1,1,10
414,@fgeerdink,Normal_users,1,1,0,15
415,@famclik,Normal_users,1,1,0,12
416,@dimemag,Normal_users,4,1,3,4
417,@crashoverride_,top_twitters,16,0,16,4
418,@bieber_turkey,Normal_users,7,4,3,9
419,@asternwarning,Normal_users,19,2,17,1
421,@10musica,Normal_users,23,6,17,11
423,@westsidebg,Normal_users,2,2,0,14
425,@slimthugga,Normal_users,3,1,2,12
426,@skydigg4,Normal_users,3,1,2,11
428,@rock_n_doll,Normal_users,6,6,0,3
429,@phoenixmercury,Normal_users,2,2,0,9
430,@ozany,Normal_users,9,0,9,3
431,@orvex,Normal_users,7,5,2,5
433,@nerdatcooltable,Normal_users,3,2,1,2
435,@muathletics,Normal_users,3,2,1,4
436,@mfirataydin,Normal_users,13,3,10,1
438,@lhyozil_klose11,Normal_users,21,10,11,13
439,@kumpanyatv,Normal_users,1,0,1,15
440,@killahbon3s,Normal_users,7,3,4,4
441,@kaankural,Normal_users,7,7,0,3
443,@jflow41,Normal_users,4,2,2,7
444,@jerseychaser54,Normal_users,4,2,2,4
449,@greivisvasquez,Normal_users,1,1,0,11
450,@garudaflexi,Normal_users,30,2,28,16
452,@eyluleva,top_twitters,36,5,31,4
453,@estebanpagan,Normal_users,3,0,3,5
454,@elif_jbieber,Normal_users,15,1,14,15
455,@dibrary1004,Normal_users,1,1,0,6
456,@claytravisbgid,Normal_users,1,0,1,7
457,@claraiueo,Normal_users,11,6,5,14
458,@chrisbosh,Normal_users,3,0,3,15
459,@canbball,Normal_users,3,3,0,2
463,@bajamusica,Normal_users,6,6,0,12
465,@abscbnnewssport,Normal_users,3,3,0,10
466,@zeynepcetin,Normal_users,12,4,8,9
467,@yhdodream,Normal_users,10,2,8,7
472,@therevofmge,Normal_users,4,2,2,4
473,@stephenasmith,Normal_users,1,1,0,13
474,@stackmack,Normal_users,9,2,7,3
476,@s_segurola,Normal_users,2,1,1,14
478,@robkardashian,Normal_users,1,1,0,13
480,@preston76,Normal_users,6,1,5,5
482,@mustafakotan,Normal_users,3,3,0,15
483,@mundodeportivo,Normal_users,10,4,6,10
486,@meridianotv,Normal_users,3,3,0,7
488,@jose3030,Normal_users,3,0,3,15
489,@jonasbrotherstr,Normal_users,2,0,2,13
491,@halifaxrainmen,Normal_users,10,2,8,1
496,@elnuevodia,Normal_users,2,1,1,5
497,@dragonflyjonez,Normal_users,6,3,3,4
500,@chelly_davilla7,Normal_users,11,6,5,11
501,@cargun,Normal_users,6,3,3,5
502,@buduoriginal,Normal_users,3,2,1,11
503,@birkanbatuk,Normal_users,2,2,0,15
505,@basketballbuzz,Normal_users,13,3,10,1
506,@basketball_bild,Normal_users,3,3,0,2
507,@antigonoulalp,Normal_users,33,8,25,1
508,@aciyokrocky,Normal_users,8,4,4,15
514,@ssergioh,Normal_users,1,1,0,5
515,@sninsider,Normal_users,3,3,0,6
516,@serenawilliams,Normal_users,2,2,0,12
519,@scoopdez30,Normal_users,4,3,1,9
521,@roscoedash,Normal_users,2,2,0,10
522,@realjaywilliams,Normal_users,3,2,1,1
523,@raphiellej,Normal_users,5,0,5,1
524,@pacogcaridad,Normal_users,3,2,1,10
527,@nsane11,Normal_users,4,0,4,2
528,@naominiles,Normal_users,2,0,2,4
529,@nadialerman,Normal_users,26,7,19,8
532,@milosdjajic,Normal_users,6,2,4,15
533,@mfowen91,Normal_users,1,1,0,7
534,@melfernando20,Normal_users,7,2,5,2
537,@m__rafif,Normal_users,22,10,12,11
541,@lacn,Normal_users,4,3,1,1
543,@kvasniova,Normal_users,3,2,1,2
546,@jgreene20,Normal_users,4,4,0,14
547,@jetaimenick,Normal_users,48,5,43,4
550,@insidethehall,Normal_users,3,2,1,3
551,@highmajor1,Normal_users,3,0,3,6
552,@herbertfromfg,Normal_users,1,0,1,11
553,@gpway,Normal_users,2,0,2,1
556,@gabyee,Normal_users,7,3,4,6
558,@eniac,Normal_users,3,3,0,15
562,@coachfinamore,Normal_users,3,0,3,3
563,@coachdanefife,Normal_users,1,1,0,14
565,@cagridemirsen,Normal_users,2,1,1,9
566,@burak,Normal_users,2,1,1,15
568,@blunted215,Normal_users,1,1,0,6
569,@blairjordans,Normal_users,2,1,1,12
574,@andystalman,Normal_users,2,1,1,15
575,@amy_twx,Normal_users,3,1,2,2
576,@al_primertoque,Normal_users,12,6,6,5
577,@abscbnnews,Normal_users,3,0,3,10
578,@aaronharris12,Normal_users,16,8,8,1
579,@a2dao,Normal_users,2,1,1,16
580,@_emmaella_,Normal_users,24,11,13,9
581,@1x1sports,Normal_users,2,1,1,7
582,@womworldnokia,Normal_users,2,2,0,4
583,@willthethrillb5,Normal_users,4,2,2,4
584,@veehutch,Normal_users,3,2,1,8
585,@twittyyanne,Normal_users,1,0,1,1
586,@tsnmike,Normal_users,3,0,3,3
588,@teamcarmelo15,Normal_users,10,1,9,2
589,@tcal1420,Normal_users,4,2,2,16
590,@tarheelwire,Normal_users,1,1,0,13
591,@slmandel,Normal_users,1,1,0,6
592,@skiinniemiinnie,Normal_users,3,2,1,16
594,@sincerely_nell,Normal_users,1,1,0,10
595,@simplylucylu,Normal_users,4,2,2,3
596,@sikimdentwitler,Normal_users,4,2,2,15
597,@selenajustsmile,Normal_users,9,5,4,4
598,@rafaelbello,Normal_users,4,2,2,11
602,@osulighty23,Normal_users,7,3,4,6
604,@nabilarrrr,Normal_users,20,7,13,3
605,@nabilahannisa,Normal_users,15,8,7,7
606,@n3rmn,Normal_users,6,3,3,15
607,@mobucketz,Normal_users,9,3,6,5
609,@mgrif32,Normal_users,1,0,1,6
610,@mervetufaner,Normal_users,9,0,9,15
612,@llcoolkidd,Normal_users,1,0,1,9
613,@ligadevenezuela,Normal_users,8,2,6,6
614,@laraskamila,Normal_users,16,8,8,3
615,@karinadlove,Normal_users,20,11,9,13
616,@juliagillard,Normal_users,1,1,0,3
621,@ismailsenol,Normal_users,10,7,3,3
622,@inaimathi,Normal_users,6,6,0,11
623,@ibethyyu,Normal_users,14,10,4,7
624,@hongss,Normal_users,6,4,2,7
625,@hollywuddivorce,Normal_users,2,1,1,10
626,@gladyssoo,Normal_users,19,11,8,9
627,@germanpaoloski,Normal_users,1,1,0,11
628,@erinandrews,Normal_users,1,1,0,4
630,@dlproduction,Normal_users,15,3,12,10
631,@danmike1,Normal_users,1,0,1,17
633,@clfkorea,Normal_users,4,2,2,6
634,@chris_loves_la,Normal_users,2,0,2,4
635,@cescindofan,Normal_users,3,1,2,6
636,@cesc4official,Normal_users,1,1,0,6
637,@brooksbell,Normal_users,7,5,2,12
638,@brandyisabamf,Normal_users,19,4,15,8
639,@blahitsjasmine,Normal_users,8,4,4,15
643,@arkanoid13,Normal_users,11,5,6,3
646,@ajc,Normal_users,1,0,1,3
647,@airjordyn_,Normal_users,16,5,11,1
648,@abusnel,Normal_users,3,0,3,8
651,@wojyahoonba,Normal_users,4,2,2,2
653,@virtualtotte,Normal_users,3,1,2,9
654,@varrez,Normal_users,67,10,57,1
656,@umitozmen,Normal_users,8,2,6,6
662,@schoenendunk,Normal_users,1,1,0,1
665,@rikiflo,Normal_users,1,0,1,16
666,@richboomporter,Normal_users,1,1,0,2
667,@qbkilla,Normal_users,1,1,0,4
669,@peter_r_casey,Normal_users,5,1,4,2
670,@pengovsky,Normal_users,4,3,1,5
671,@paulbyrom,Normal_users,1,1,0,5
673,@netw3rk,Normal_users,9,3,6,4
674,@nbadraftinsider,Normal_users,3,3,0,10
677,@miibasyar,Normal_users,18,10,8,11
678,@memetjamet,Normal_users,4,2,2,17
679,@melbournebuzz,Normal_users,5,1,4,3
680,@martinreyes14,Normal_users,1,1,0,16
681,@marcacom,Normal_users,3,0,3,14
682,@luoldeng9,Normal_users,1,1,0,6
684,@lia_chip_chip,Normal_users,8,4,4,8
685,@lastinactiveman,Normal_users,2,1,1,8
687,@kevin_rudds_cat,Normal_users,2,1,1,5
692,@jasmineloew,Normal_users,7,7,0,3
694,@ifeeldzy,Normal_users,2,1,1,2
695,@hokieguru,Normal_users,1,1,0,6
696,@geoffproud,Normal_users,4,2,2,12
697,@ganchetto,Normal_users,3,1,2,8
700,@firstladyeve,Normal_users,2,1,1,17
701,@fiba,Normal_users,1,1,0,15
702,@ernestodelvalle,Normal_users,4,2,2,17
703,@eric__smith,Normal_users,1,0,1,8
707,@eil82,Normal_users,16,7,9,4
709,@dcdebbie,Normal_users,6,2,4,8
710,@danielkelly9,Normal_users,1,0,1,8
712,@d_rosefans,Normal_users,14,1,13,2
714,@conversion_doc,Normal_users,2,1,1,3
717,@canballreport,Normal_users,3,0,3,7
719,@brigunn,Normal_users,8,4,4,3
720,@briancmahoney,Normal_users,6,2,4,2
721,@boxdenfresh,Normal_users,5,5,0,14
722,@bizarreavenir,Normal_users,14,7,7,9
723,@barbeenicole,Normal_users,1,1,0,2
724,@atlantadream,Normal_users,1,1,0,9
726,@allstarweekend,Normal_users,1,1,0,3
727,@allan_houston,Normal_users,2,1,1,16
730,@aarbeloa17,Normal_users,1,1,0,5
731,@zeljkomatic,Normal_users,19,0,19,1
732,@yukafellicia,Normal_users,14,9,5,7
734,@yahoo,Normal_users,1,1,0,4
738,@vh1info,Normal_users,6,3,3,8
739,@v_emman,Normal_users,4,1,3,6
740,@umhoops,Normal_users,3,0,3,3
743,@twinsselen,Normal_users,6,0,6,12
744,@turkeysforlife,Normal_users,2,1,1,16
747,@thewizardozlm,Normal_users,19,8,11,9
750,@swiperboy,Normal_users,2,1,1,2
751,@susan_shan,Normal_users,6,3,3,5
753,@slashredtape,Normal_users,3,1,2,8
757,@sharminultra,Normal_users,4,2,2,16
758,@sbjlizmullen,Normal_users,1,0,1,12
759,@sarayelich,Normal_users,2,2,0,8
760,@rjmbasket08,Normal_users,12,4,8,2
761,@ricbucher,Normal_users,1,1,0,17
763,@reeseosu24,Normal_users,1,1,0,14
764,@raytwoblessed,Normal_users,4,2,2,3
765,@quseans,Normal_users,1,1,0,15
766,@quotinguncfans,Normal_users,2,0,2,7
770,@pacorabadan,Normal_users,4,2,2,4
771,@onnaboat,Normal_users,8,3,5,3
774,@nbafumi32,Normal_users,26,6,20,3
778,@n_aygun,Normal_users,14,4,10,5
779,@mutluska,Normal_users,2,1,1,2
780,@lovely_cloud,Normal_users,2,1,1,3
781,@lisabellomusic,Normal_users,4,2,2,16
782,@lasty52,Normal_users,1,1,0,10
783,@lala,Normal_users,1,1,0,2
784,@laclippers,Normal_users,1,0,1,6
786,@keilanyinked,Normal_users,2,1,1,11
788,@karinair,Normal_users,11,5,6,3
789,@justanormalcat,Normal_users,1,1,0,2
794,@irmakkahraman,Normal_users,15,9,6,12
796,@indahayua,Normal_users,15,7,8,7
797,@ilovelambertx,Normal_users,13,1,12,7
799,@harmonwrites,Normal_users,1,0,1,15
800,@grisegeunsuk,Normal_users,29,9,20,7
801,@getlucky23,Normal_users,2,2,0,10
802,@gaydowntown,Normal_users,27,8,19,1
803,@funa1018,top_twitters,12,2,10,2
804,@fuckthepublic,Normal_users,1,1,0,13
806,@espn_bigten,Normal_users,1,1,0,5
808,@ellamayamaya,Normal_users,22,9,13,3
809,@elgraficionado,Normal_users,12,6,6,1
810,@eduardoschell,Normal_users,7,1,6,5
811,@dukehoopblog,Normal_users,3,1,2,4
813,@djalizay,Normal_users,2,1,1,14
815,@dharealmcclain,Normal_users,2,1,1,15
817,@dcabellor,Normal_users,2,0,2,17
818,@dantehiggins,Normal_users,2,2,0,3
819,@cumonluigi,Normal_users,2,1,1,17
820,@cuffsthelegend,Normal_users,1,0,1,12
821,@coachpurnell,Normal_users,1,0,1,16
823,@closmoney,Normal_users,5,1,4,12
827,@cdiddy713,Normal_users,9,4,5,14
828,@bwil12,Normal_users,1,1,0,11
829,@boostmobile,Normal_users,8,4,4,1
832,@basketnews,Normal_users,7,4,3,8
833,@barackobussa,Normal_users,4,2,2,1
834,@ayu_xuefreiz,Normal_users,9,9,0,7
835,@aqua174,Normal_users,3,3,0,13
837,@angelasimmons,Normal_users,2,1,1,9
838,@amandathebamma,Normal_users,1,1,0,8
840,@aimee_rhodes,Normal_users,1,1,0,11
841,@ai3_9,Normal_users,9,9,0,4
843,@_samanthamunro,Normal_users,1,1,0,8
847,@ymoy,Normal_users,14,8,6,11
848,@yerrp08,Normal_users,4,2,2,11
851,@we_r_fly,Normal_users,3,1,2,6
852,@vlknkckndr,Normal_users,4,1,3,3
854,@usasports,Normal_users,8,4,4,3
855,@ufukkilic,Normal_users,1,1,0,12
857,@twitter,Normal_users,1,1,0,2
858,@toqueygambeta,Normal_users,3,0,3,8
860,@tomsatkowiak,Normal_users,1,1,0,17
866,@thelifeofsdot,Normal_users,3,1,2,11
870,@ssowy,Normal_users,1,0,1,16
872,@sofianaaaa,Normal_users,15,8,7,3
874,@sirhoopsalot,Normal_users,2,1,1,11
877,@sergioscariolo,Normal_users,2,2,0,14
879,@selection_int,Normal_users,9,7,2,3
882,@sandraniehaus,Normal_users,2,1,1,4
884,@russbengtson,Normal_users,6,2,4,5
887,@redhoops,Normal_users,5,3,2,15
889,@rebotero,Normal_users,2,2,0,6
890,@realteambreezy,Normal_users,1,0,1,7
891,@rafzhaf,Normal_users,8,4,4,11
892,@rafaelschoch,Normal_users,6,3,3,6
893,@radiodeck,Normal_users,4,2,2,4
895,@qlder,Normal_users,2,1,1,3
902,@ozgesahinler,Normal_users,1,0,1,15
904,@omatic12,Normal_users,9,1,8,6
905,@nycking,Normal_users,15,0,15,1
906,@nolieala,Normal_users,2,1,1,17
907,@nmonroe,Normal_users,8,1,7,1
910,@nickflynt,Normal_users,8,1,7,4
912,@n1temare_som,Normal_users,2,1,1,7
915,@mslee122380,Normal_users,4,2,2,13
916,@mr_pokeherface,Normal_users,3,1,2,14
917,@mojohoops,Normal_users,6,3,3,3
918,@mits21,Normal_users,4,2,2,5
919,@miss_ccee,Normal_users,5,3,2,4
920,@mhaubs,Normal_users,4,3,1,1
921,@mf_mikegeezy,Normal_users,2,1,1,11
922,@martinezferran,Normal_users,8,3,5,5
929,@julie_posetti,Normal_users,1,1,0,4
930,@jtthekid,Normal_users,4,1,3,7
931,@jimmyfallon,Normal_users,1,1,0,13
932,@jeffboals,Normal_users,1,0,1,8
933,@jameernelson,Normal_users,2,2,0,11
934,@j_loso,Normal_users,4,2,2,9
935,@iwculalpbourdie,Normal_users,12,7,5,3
937,@iranriggedelect,Normal_users,1,1,0,5
939,@ibiil,Normal_users,4,2,2,7
940,@ibieberette,Normal_users,2,1,1,10
941,@huuugoo,Normal_users,4,2,2,4
943,@hepburnlove,Normal_users,4,1,3,15
944,@hectorfernandez,Normal_users,2,0,2,15
945,@hail_zel,Normal_users,5,3,2,7
946,@habercimurat,Normal_users,6,3,3,15
947,@gobluetree629,Normal_users,12,6,6,2
948,@gesiu,Normal_users,2,0,2,1
949,@frendywayne,Normal_users,13,8,5,7
952,@firzayenti,Normal_users,13,7,6,7
955,@exsequar,Normal_users,4,1,3,8
956,@everaldomarques,Normal_users,2,1,1,2
957,@estetikbocek,Normal_users,11,0,11,12
962,@donjuanjean,Normal_users,2,1,1,13
963,@diiamondniicole,Normal_users,5,2,3,2
965,@deshawn_datruth,Normal_users,5,2,3,4
966,@dee_rp_jetz,Normal_users,1,0,1,10
968,@czmen,Normal_users,1,0,1,1
969,@cronaldolove,Normal_users,83,3,80,4
970,@crazyboydizzy,Normal_users,4,2,2,3
971,@conniechris,Normal_users,2,1,1,11
974,@chineylee,Normal_users,1,1,0,2
977,@cbas28,Normal_users,4,0,4,7
978,@camsymarquina,Normal_users,1,1,0,16
979,@callmefantastic,Normal_users,1,0,1,14
980,@cagancaglar,Normal_users,2,0,2,15
981,@c_woody43,Normal_users,1,0,1,16
982,@bxcmusic,Normal_users,1,1,0,6
984,@blogdoamorim,Normal_users,5,1,4,5
986,@blak304,Normal_users,4,2,2,2
989,@believeinme14,Normal_users,2,1,1,16
990,@bdahtonwildnout,Normal_users,2,0,2,6
992,@bagmesli,Normal_users,2,1,1,16
995,@avinash,Normal_users,2,2,0,7
996,@ash_ley_103,Normal_users,2,1,1,10
997,@antaniaxd,Normal_users,3,1,2,4
998,@ann2066,Normal_users,1,1,0,9
1001,@agarner,Normal_users,2,2,0,3
1003,@acadenas,Normal_users,2,1,1,6
1005,@143alley,Normal_users,2,1,1,5
1006,@yomommaahoehuh,Normal_users,1,0,1,10
1007,@yaseminograli,Normal_users,1,1,0,7
1013,@webconversion,Normal_users,3,3,0,14
1017,@ubctbirds,Normal_users,1,1,0,7
1024,@tiwi_kimzter,Normal_users,2,1,1,9
1027,@thereallaine,Normal_users,4,2,2,14
1028,@thefacelessspin,Normal_users,2,1,1,16
1032,@temporealagora,Normal_users,1,0,1,16
1033,@tekehalil,Normal_users,5,2,3,15
1035,@teamziller,Normal_users,5,2,3,6
1036,@tareckpsuv,Normal_users,2,0,2,17
1037,@sugahill,Normal_users,2,1,1,10
1038,@subakros,Normal_users,2,1,1,9
1040,@stonetemple,Normal_users,2,2,0,10
1041,@stein_line_hq,Normal_users,1,0,1,17
1042,@stagetiger,Normal_users,8,2,6,5
1046,@soniaandstitch,Normal_users,1,1,0,11
1049,@slam52,Normal_users,7,7,0,5
1051,@shizzy5,Normal_users,2,1,1,10
1053,@shabrinabiebs,Normal_users,13,7,6,7
1055,@sdotcurry,Normal_users,2,0,2,15
1056,@salmaehee,Normal_users,4,2,2,13
1057,@ryandeshanaa,Normal_users,4,2,2,13
1061,@rodb3in1,Normal_users,12,5,7,10
1062,@realthornberry,Normal_users,2,1,1,5
1063,@realskipbayless,Normal_users,1,1,0,15
1064,@realbeauty_,Normal_users,8,4,4,7
1065,@raulalzaga,Normal_users,3,3,0,5
1067,@rainoananta,Normal_users,14,7,7,15
1068,@quiquegaray,Normal_users,2,1,1,13
1070,@professorcc,Normal_users,2,1,1,3
1072,@pinarakal1,Normal_users,2,0,2,15
1073,@pikawr,Normal_users,13,7,6,3
1074,@philbellamyinc,Normal_users,6,2,4,3
1077,@pedroasouto,Normal_users,3,2,1,6
1078,@peasantplease,Normal_users,10,3,7,16
1080,@paul_tomkins,Normal_users,1,0,1,7
1082,@paquadiva,Normal_users,10,5,5,3
1084,@pamcaulfield,Normal_users,7,1,6,12
1086,@oyleboylesoyle,Normal_users,36,0,36,9
1088,@omerekinci,Normal_users,1,1,0,10
1091,@nothinbutnetash,Normal_users,2,0,2,2
1092,@nmhbasketball,Normal_users,2,0,2,11
1095,@ncerenargon,Normal_users,4,0,4,15
1096,@nbahistory,Normal_users,1,1,0,12
1097,@nbabasketball,Normal_users,1,1,0,6
1098,@naznasman,Normal_users,3,2,1,4
1099,@natebmafia,Normal_users,7,3,4,1
1100,@nadyasri,Normal_users,2,1,1,7
1101,@mzthickumzjuicy,Normal_users,8,4,4,16
1105,@ms_busyb0dy,Normal_users,2,1,1,14
1106,@moon_williams0,Normal_users,2,1,1,2
1108,@miirrceezzz,Normal_users,14,7,7,15
1109,@miharejc,Normal_users,4,2,2,1
1111,@mertevgin,Normal_users,6,1,5,4
1113,@memphissportfan,Normal_users,7,4,3,1
1117,@marquetteu,Normal_users,3,1,2,4
1121,@malodemolinaacb,Normal_users,1,0,1,6
1125,@maalikwayns2,Normal_users,1,1,0,6
1126,@luckyovlegends,Normal_users,1,0,1,16
1128,@lkrgirl,Normal_users,2,0,2,4
1129,@lita_nuno,Normal_users,17,7,10,7
1130,@lickmyj0rdans,Normal_users,2,1,1,10
1134,@kiddme2,Normal_users,4,2,2,3
1135,@khoshkeledoc,Normal_users,1,0,1,5
1137,@keylon_b,Normal_users,5,2,3,9
1138,@kerryrhodes,Normal_users,1,1,0,9
1139,@kdonhoops,Normal_users,1,0,1,14
1142,@jrstarcamper,Normal_users,8,4,4,6
1144,@jonrothstein,Normal_users,3,0,3,6
1145,@jonahballow,Normal_users,1,0,1,16
1148,@jessetenay,Normal_users,1,1,0,12
1149,@jermainemcfly,Normal_users,2,1,1,6
1151,@jeffrabjohns,Normal_users,1,1,0,6
1154,@jasshapire,Normal_users,13,7,6,10
1156,@its_msjrich,Normal_users,3,1,2,4
1158,@ipeksenoglu,Normal_users,3,3,0,4
1159,@incultolt,Normal_users,1,1,0,16
1160,@imsokentucky,Normal_users,4,1,3,3
1161,@ifxckdtigerwife,Normal_users,6,3,3,7
1162,@ibiebergaga,Normal_users,8,4,4,17
1163,@iarse,Normal_users,4,2,2,5
1166,@horadomac,Normal_users,4,2,2,4
1169,@hapsarianggita,Normal_users,6,3,3,7
1171,@granma_digital,Normal_users,1,0,1,17
1174,@gbiee,Normal_users,4,2,2,3
1175,@freekeyty30,Normal_users,4,2,2,12
1177,@fhevier,Normal_users,20,3,17,1
1179,@fermartinmartin,Normal_users,1,1,0,15
1180,@ferescalona13,Normal_users,6,0,6,6
1184,@evooba,Normal_users,16,4,12,1
1185,@espn_bigeast,Normal_users,3,2,1,14
1186,@ertannnn,Normal_users,3,0,3,5
1188,@duniasoccer,Normal_users,5,5,0,7
1192,@dcana,Normal_users,3,0,3,4
1193,@daxenpower,Normal_users,11,6,5,10
1195,@darylt3,Normal_users,3,1,2,11
1197,@crazyloud411,Normal_users,9,5,4,5
1198,@coolkidroach,Normal_users,4,2,2,5
1199,@colombianospaz,Normal_users,3,1,2,2
1200,@collegehill_ant,Normal_users,3,0,3,9
1203,@chiyeezy,Normal_users,2,0,2,11
1204,@chiefmartec,Normal_users,3,1,2,10
1206,@cazadoresbball,Normal_users,4,1,3,6
1208,@canemutiny5x,Normal_users,1,0,1,15
1209,@callme_boobie,Normal_users,2,1,1,11
1210,@bytimreynolds,Normal_users,2,1,1,8
1212,@burcinguney,Normal_users,15,6,9,6
1213,@brwnsugat,Normal_users,3,1,2,3
1215,@booksmartdevl,Normal_users,2,1,1,14
1216,@blasondamadrid,Normal_users,2,0,2,15
1217,@blakfoksdtp,Normal_users,5,2,3,6
1218,@bigtiggershow,Normal_users,2,1,1,7
1219,@benno_15,Normal_users,2,0,2,7
1220,@bebacklatersoon,Normal_users,8,2,6,9
1221,@bbusilleon,Normal_users,2,1,1,7
1223,@bballworldltu,Normal_users,10,4,6,1
1224,@basseyworldlive,Normal_users,3,1,2,6
1225,@baskonia,Normal_users,1,1,0,7
1228,@baloncestofeb,Normal_users,1,1,0,17
1229,@ballislife,Normal_users,1,0,1,3
1231,@ayoyouseentommy,Normal_users,7,3,4,1
1233,@augustobalcone,Normal_users,4,2,2,8
1234,@aspirates,Normal_users,6,5,1,3
1238,@andobig,Normal_users,2,1,1,16
1239,@amazinmixbeauti,Normal_users,1,0,1,9
1240,@alcuinpapa,Normal_users,4,3,1,15
1241,@aenguscollins,Normal_users,3,1,2,15
1242,@addictedtomiles,Normal_users,3,3,0,7
1243,@acook_1,Normal_users,2,1,1,10
1244,@_primadonna22,Normal_users,5,2,3,10
1246,@_dilek__,Normal_users,17,1,16,5
1247,@8leggedfreak_1,Normal_users,2,1,1,7
1249,@zwyback,Normal_users,2,2,0,11
1250,@zizu100,Normal_users,7,3,4,10
1253,@xenxenaaaa,Normal_users,6,3,3,11
1256,@wrumsby,Normal_users,5,2,3,6
1257,@wjalu,Normal_users,6,3,3,10
1259,@whymelawd,Normal_users,1,0,1,8
1262,@wccsports,Normal_users,1,0,1,5
1263,@vitinos,Normal_users,4,4,0,1
1264,@virginiaselly,Normal_users,7,3,4,14
1266,@vickacang,Normal_users,6,3,3,1
1267,@under_armour,Normal_users,1,0,1,11
1269,@udreadmedntu,Normal_users,2,1,1,4
1270,@udjudj,Normal_users,3,0,3,11
1274,@treykerby,Normal_users,7,2,5,1
1276,@tommycuss,Normal_users,4,2,2,17
1280,@tinapperez,Normal_users,2,0,2,2
1282,@theupsetblog,Normal_users,6,3,3,5
1285,@theonion,Normal_users,1,1,0,4
1286,@thenyknicks,Normal_users,6,2,4,10
1287,@themoonshield,Normal_users,1,0,1,15
1289,@theheirofdalou,Normal_users,6,3,3,12
1294,@tharealbr,Normal_users,4,2,2,16
1298,@tengchangkhim,Normal_users,2,1,1,13
1301,@teakolik,Normal_users,3,0,3,10
1303,@syjihan,Normal_users,1,0,1,11
1305,@swaggerificdrew,Normal_users,2,1,1,14
1306,@surtifiedlady,Normal_users,2,1,1,8
1311,@stilgherrian,Normal_users,1,1,0,8
1313,@sputnikjkb,Normal_users,1,1,0,12
1315,@sporty1989,Normal_users,1,0,1,2
1317,@sooheepark,Normal_users,5,4,1,7
1322,@sixers,Normal_users,3,0,3,16
1323,@simgegulsah,Normal_users,2,0,2,15
1325,@shawtyredd253,Normal_users,2,2,0,14
1327,@serdargurel,Normal_users,8,6,2,4
1330,@satryasjukri,Normal_users,7,5,2,13
1332,@saranade_me,Normal_users,3,1,2,14
1333,@russrozay,Normal_users,2,1,1,7
1334,@rpb2010,Normal_users,4,2,2,11
1336,@rolmon99,Normal_users,4,2,2,5
1337,@rocboyflossy,Normal_users,1,0,1,8
1338,@rlgordon87,Normal_users,2,1,1,11
1339,@rizkyramadan,Normal_users,2,1,1,11
1342,@rhondadtp,Normal_users,2,1,1,5
1343,@renabilgin,Normal_users,6,0,6,12
1344,@rellevent21,Normal_users,2,1,1,3
1349,@realshiive,Normal_users,4,2,2,3
1352,@qmccall3,Normal_users,4,1,3,12
1355,@propain713,Normal_users,5,3,2,14
1356,@prohoopsjournal,Normal_users,4,2,2,12
1362,@people_skills,Normal_users,3,0,3,6
1363,@pedritoortizjr,Normal_users,2,1,1,11
1364,@patriciobruno,Normal_users,7,1,6,1
1366,@pandji,Normal_users,3,2,1,10
1368,@ozgeah,Normal_users,4,1,3,12
1372,@nolanshulman,Normal_users,2,2,0,3
1373,@nixonstw1tter,Normal_users,9,3,6,3
1374,@ninisfirdia,Normal_users,13,6,7,3
1375,@nickweisser,Normal_users,5,3,2,7
1376,@nessabiggaveli,Normal_users,6,3,3,1
1377,@neclacebel,Normal_users,16,5,11,10
1379,@nbadraftblog,Normal_users,3,0,3,3
1381,@nannersmom,Normal_users,1,0,1,9
1382,@naebabyy,Normal_users,1,0,1,10
1383,@nadialestari,Normal_users,8,4,4,10
1385,@my_diaries,Normal_users,13,1,12,5
1386,@mukhammadrouf,Normal_users,2,1,1,11
1387,@msgnyc,Normal_users,2,2,0,6
1393,@mizztahdwayne,Normal_users,7,1,6,6
1398,@miramiraput,Normal_users,2,1,1,11
1401,@mifblip,Normal_users,1,1,0,3
1403,@metallikar,Normal_users,3,1,2,7
1404,@melroseeeem,Normal_users,2,1,1,16
1405,@medyrarrr,Normal_users,6,3,3,11
1406,@mediaroyaltii,Normal_users,1,0,1,9
1408,@maya_mi,Normal_users,9,5,4,5
1410,@matjasec,Normal_users,2,1,1,12
1411,@manuelressel,Normal_users,4,1,3,8
1412,@malbeauti,Normal_users,2,1,1,14
1414,@madeinwesafrica,Normal_users,2,1,1,1
1415,@lwrocks,Normal_users,3,1,2,8
1416,@luvlika,Normal_users,4,2,2,11
1422,@lisalisacent,Normal_users,4,2,2,17
1425,@lecairn_sport,Normal_users,2,1,1,9
1426,@leaginobili,Normal_users,2,1,1,3
1427,@ldengf,Normal_users,2,0,2,6
1431,@lakersreporter,Normal_users,3,1,2,7
1432,@lakersnation,Normal_users,3,2,1,4
1433,@lakergirls7,Normal_users,1,1,0,17
1436,@kristinasari,Normal_users,2,1,1,10
1438,@konumankeni,Normal_users,11,3,8,5
1442,@kidkwamefanclub,Normal_users,2,1,1,6
1443,@kgrant5,Normal_users,2,1,1,14
1444,@kevinding,Normal_users,1,0,1,7
1454,@jumpmanrugs,Normal_users,4,3,1,7
1458,@joeingles7,Normal_users,1,1,0,3
1459,@jimmyteguh,Normal_users,2,1,1,5
1460,@jesslca_,Normal_users,6,3,3,4
1463,@jemelehill,Normal_users,4,2,2,10
1465,@jaredmix965,Normal_users,2,1,1,14
1469,@itsagomusic,Normal_users,1,1,0,6
1470,@istor,Normal_users,8,3,5,1
1471,@isitreallycrash,Normal_users,9,3,6,13
1472,@infostradalive,Normal_users,1,0,1,16
1473,@indriinovita,Normal_users,6,3,3,13
1474,@indigenous_news,Normal_users,1,1,0,12
1475,@imanassholeikon,Normal_users,2,1,1,16
1477,@iboog,Normal_users,2,1,1,4
1478,@iamzoe33,Normal_users,4,2,2,3
1480,@iamjoycab,Normal_users,4,2,2,2
1482,@hpbasketball,Normal_users,7,1,6,3
1484,@hoopsfix,Normal_users,2,1,1,6
1485,@heycee,Normal_users,6,3,3,11
1486,@hellrider1905,Normal_users,2,1,1,9
1487,@hdubb21,Normal_users,2,1,1,10
1491,@hannahyeoh,Normal_users,2,1,1,13
1494,@glorens24,Normal_users,15,6,9,9
1498,@gabyverdier,Normal_users,2,0,2,1
1500,@frozono,Normal_users,1,1,0,6
1505,@fenneeyyy,Normal_users,2,1,1,13
1506,@fcb_eveline,Normal_users,9,4,5,11
1507,@fasttimesatrf,Normal_users,4,2,2,2
1508,@farahzekria,Normal_users,3,1,2,9
1509,@ewwdatsnaasty,Normal_users,2,1,1,11
1510,@evandanielscout,Normal_users,3,0,3,10
1511,@eusser,Normal_users,7,2,5,5
1512,@euniquel21,Normal_users,5,2,3,16
1514,@esporturismo,Normal_users,2,0,2,11
1515,@erykamarie,Normal_users,2,1,1,11
1516,@erginataman,Normal_users,6,5,1,3
1521,@emmayonce,Normal_users,4,2,2,7
1522,@emiliovescudero,Normal_users,7,1,6,5
1523,@eloelz,Normal_users,2,1,1,14
1525,@ellenyuu,Normal_users,6,3,3,5
1526,@dymon21,Normal_users,5,1,4,5
1529,@drfilomena,Normal_users,7,1,6,5
1530,@dreallday,Normal_users,5,2,3,13
1531,@dre_day20,Normal_users,2,1,1,15
1532,@doremithamithut,Normal_users,13,6,7,7
1533,@dochancock,Normal_users,1,0,1,6
1537,@dj_era,Normal_users,3,2,1,9
1538,@diniiaw,Normal_users,11,4,7,13
1540,@diamondatl,Normal_users,2,1,1,10
1541,@devonshiretea,Normal_users,2,1,1,17
1542,@devin34harris,Normal_users,6,3,3,13
1543,@devdeyam,Normal_users,6,3,3,17
1544,@dersportmanager,Normal_users,1,1,0,4
1545,@derrickmartrose,Normal_users,1,1,0,3
1548,@dearmers,Normal_users,1,0,1,14
1549,@dbudlov,Normal_users,1,0,1,12
1550,@darealmrc,Normal_users,4,1,3,3
1551,@daphvont,Normal_users,3,1,2,7
1553,@d1_ap5,Normal_users,3,2,1,6
1561,@cogufogo,Normal_users,3,1,2,6
1566,@chaselandon,Normal_users,2,1,1,9
1569,@casalfoto,Normal_users,3,1,2,8
1571,@canaltamayo,Normal_users,4,4,0,2
1572,@camronsmith,Normal_users,2,1,1,6
1573,@camptj2011,Normal_users,1,0,1,13
1575,@bronto,Normal_users,4,2,2,7
1577,@briannaxoo,Normal_users,3,1,2,9
1578,@brianmccormick,Normal_users,3,2,1,13
1579,@brianisawesome,Normal_users,5,0,5,6
1580,@briangrummell,Normal_users,8,4,4,8
1581,@brewhoop,Normal_users,3,0,3,4
1582,@brendanloy,Normal_users,8,3,5,5
1583,@borjabarba,Normal_users,2,1,1,11
1585,@blazexxxii,Normal_users,6,3,3,7
1586,@bjmillican,Normal_users,1,0,1,14
1587,@bitoongames,Normal_users,2,1,1,14
1588,@bigdaddygibbs12,Normal_users,2,1,1,13
1591,@beni_takip_et,Normal_users,6,6,0,15
1592,@belieberpin,Normal_users,2,1,1,4
1594,@basportsguy,Normal_users,2,1,1,7
1595,@basketballtalk,Normal_users,3,1,2,6
1596,@basedup_sb,Normal_users,5,2,3,10
1597,@babehbulss,Normal_users,4,2,2,17
1598,@aymargarcia,Normal_users,3,3,0,10
1599,@ayiiesekar,Normal_users,9,6,3,7
1602,@atowne07,Normal_users,1,0,1,3
1603,@astehiy,Normal_users,4,2,2,14
1604,@ashtormie,Normal_users,2,1,1,9
1606,@ashghebranious,Normal_users,3,0,3,6
1609,@antwonomous,Normal_users,1,0,1,12
1611,@andyblauig,Normal_users,1,0,1,8
1612,@andrewgreif,Normal_users,1,0,1,2
1615,@alphagilly,Normal_users,1,1,0,5
1616,@allstarami,Normal_users,1,0,1,3
1617,@allanjs73,Normal_users,1,1,0,7
1620,@aguije_net,Normal_users,8,4,4,5
1621,@adjustdafacts,Normal_users,2,1,1,13
1623,@a12dope,Normal_users,3,3,0,13
1625,@_princessjes,Normal_users,10,6,4,11
1626,@8g23,Normal_users,24,1,23,1